13,13
4,11
4444311111111
4444311111111
4444331111111
4444433111111
3333443111111
1113343111111
1111155551111
1111155551111
1111157555511
1111111165111
1111111111155
1111111111155
1111111111115
7,1,7;
