5,5
FBSXDEWXMX
KXCXFPFXDS
FRFXWXWFDX
SLSXDGFXFX
DXSXSXFCWX