14,14
1,1
00006060000000
00010370304070
60302007706000
07030370071400
35700720060061
01770330470400
00751070063330
33703700236107
65507761707360
07731060077700
60373304677033
73077770600360
00550037735030
77070707600070
